XXXXXXXXXXXX 
X....X.X.X.X 
X...e..X.XXX 
X.X.sX.X.X.X 
X...XX.X...X
X........X.X 
X..X...X...X 
XXXXXXXXXXXX